///////////////////
###################
#........#........#
#.##.###.#.###.##.#
#.................#
#.##.#.#####.#.##.#
#....#...#...#....#
####.###.#.###.####
$$$#.#///////#.#$$$
####.#/##+##/#.####
////../#$$$#/..////
####.#/#####/#.####
$$$#.#///@///#.#$$$
####.#.#####.#.####
#........#........#
#.##.###.#.###.##.#
#..#...........#..#
##.#.#.#####.#.#.##
#....#...#...#....#
#.######.#.######.#
#.................#
###################