///////////////////
###################
#........#........#
#*##.###.#.###.##*#
#.##.###.#.###.##.#
#.................#
#.##.#.#####.#.##.#
#....#...#...#....#
####.###/#/###.####
///#.#///r///#.#///
####.#/##_##/#.####
////.//#bpo#//.////
####.#/#####/#.####
///#.#///////#.#///
####.#/#####/#.####
#........#........#
#.##.###.#.###.##.#
#*.#.....@.....#.*#
##.#.#.#####.#.#.##
#....#...#...#....#
#.######.#.######.#
#.................#
###################
///////////////////